8 8 60
=...=2.=
@#.1=..=
=====..=
=1!2=*==
=====..=
kmtw...=
.......=
========