10 10 -1
0*..=0.*#@
**..=.!*##
....=.!***
....=.!!!.
....=.....
....=#====
....=...$$
....=...$$
....#...$$
kmwt=...$$