15 15 200
===============
=k.=1=^.....!m=
=.##.=......!!=
======.......^=
=$............=
=$............=
====.......====
=0#$.......=0@=
====.......====
=1^...........=
=^^...........=
=.............=
=...........**=
=w...^......*t=
===============